0,0,0,0,0,0,0,0,0,0,0,0,0,0,0,0
0,0,3,0,0,0,13,0,0,13,0,0,0,3,0,0
0,4,8,4,0,3,3,3,3,3,3,0,4,8,4,0
0,4,2,2,2,8,2,4,4,2,8,2,2,2,4,0
0,13,4,13,0,0,0,0,0,0,0,0,13,4,13,0
0,0,0,14,14,14,0,0,0,0,0,14,14,0,0,0
0,2,0,0,14,0,0,0,0,0,0,14,0,0,2,0
0,3,2,2,0,0,0,0,0,0,0,0,2,2,3,0
0,0,0,0,0,0,0,0,0,0,0,0,0,0,0,0
0,0,0,0,0,0,0,0,0,0,0,0,0,0,0,0