0,0,0,0,0,0,0,0,0,0,0,0,0,0,0,0
0,0,10,10,10,10,10,10,10,10,10,10,10,10,0,0
0,0,8,0,0,0,0,0,0,0,0,0,0,8,0,0
0,0,10,10,10,10,10,10,10,10,10,10,10,10,0,0
0,0,9,9,9,9,9,9,9,9,9,9,9,9,0,0
0,0,11,8,11,10,10,10,10,10,10,11,8,11,0,0
0,0,11,11,11,0,0,0,0,0,0,11,11,11,0,0
0,0,0,0,0,0,0,0,0,0,0,0,0,0,0,0
0,0,0,0,0,0,0,0,0,0,0,0,0,0,0,0
0,0,0,0,0,0,0,0,0,0,0,0,0,0,0,0