0,0,0,0,0,0,3,13,8,3,0,0,0,0,0,0
8,0,0,0,0,3,8,0,0,13,3,0,0,0,0,13
0,13,0,0,3,13,0,0,0,0,8,3,0,0,8,0
3,0,8,0,8,0,3,0,0,3,0,13,0,13,0,3
0,3,0,13,0,3,0,0,0,0,3,0,8,0,3,0
0,0,3,0,3,0,0,3,3,0,0,3,0,3,0,0
0,0,0,3,0,0,3,4,4,3,0,0,3,0,0,0
0,0,0,0,0,3,4,13,13,4,3,0,0,0,0,0
0,0,0,0,0,0,3,4,4,3,0,0,0,0,0,0
0,0,0,0,0,0,0,3,3,0,0,0,0,0,0,0