0,0,0,0,0,0,0,0,0,0,0,0,0,0,0,0
0,0,10,10,10,10,10,10,10,10,10,10,10,10,0,0
0,0,10,8,0,0,0,0,0,0,0,0,8,10,0,0
0,0,11,10,10,10,10,10,10,10,10,10,10,11,0,0
0,0,11,10,10,10,8,8,10,10,10,10,10,10,0,0
0,0,11,10,11,10,11,11,10,10,10,11,8,11,0,0
0,0,11,10,11,0,0,0,0,0,0,11,10,11,0,0
0,0,11,10,11,0,0,0,0,0,0,11,10,11,0,0
0,0,11,10,11,0,0,0,0,0,0,11,10,11,0,0
9,9,9,9,9,9,9,0,0,9,9,9,9,9,9,9