0,0,0,3,3,13,13,3,3,13,13,3,3,0,0,0
0,0,0,0,0,0,0,0,0,0,0,0,0,0,0,0
3,3,0,13,13,0,0,13,13,0,0,13,13,0,3,3
0,0,8,13,13,13,13,8,8,13,13,13,13,8,0,0
0,3,3,13,13,0,0,13,13,0,0,13,13,3,3,0
0,0,0,0,0,0,0,0,0,0,0,0,0,0,0,0
0,0,0,3,3,3,3,3,3,3,3,3,3,0,0,0
0,0,0,3,3,0,0,3,3,0,0,3,3,0,0,0
0,0,0,0,0,0,0,0,0,0,0,0,0,0,0,0
0,0,0,0,0,0,0,0,0,0,0,0,0,0,0,0