13,5,2,2,2,2,2,2,2,2,2,2,2,2,2,2
2,2,2,2,2,13,2,0,9,9,9,2,2,3,8,2
2,2,9,2,0,2,4,2,0,9,0,2,13,2,3,2
2,9,9,0,4,4,8,3,2,0,2,2,5,3,2,2
2,2,2,0,2,4,3,2,9,2,9,2,9,0,0,2
2,2,2,9,2,2,9,2,2,2,2,9,0,0,13,2
2,2,5,2,2,9,2,2,3,2,8,2,9,0,9,2
2,9,9,13,2,2,3,3,3,2,9,9,9,9,2,2
2,2,9,9,9,0,0,3,2,2,2,2,0,2,2,2
2,2,2,2,2,2,0,0,0,2,2,2,2,2,2,2