0,0,0,0,0,0,0,0,0,0,0,0,0,0,0,0
0,13,13,13,13,0,0,0,0,0,0,13,13,13,13,0
0,3,8,8,3,0,0,0,0,0,0,3,8,8,3,0
0,2,8,8,2,0,0,0,0,0,0,2,8,8,2,0
0,4,4,4,4,0,0,0,0,0,0,4,4,4,4,0
0,0,0,0,0,0,0,0,0,0,0,0,0,0,0,0
0,0,0,0,0,0,13,13,13,13,0,0,0,0,0,0
0,0,0,0,0,0,3,8,8,3,0,0,0,0,0,0
0,0,0,0,0,0,2,8,8,2,0,0,0,0,0,0
0,0,0,0,0,0,4,4,4,4,0,0,0,0,0,0