1,1,1,1,1,1,1,1,1,1,1,1,1,1,1,1
1,16,16,16,16,16,16,16,16,16,16,16,16,16,16,1
1,16,0,0,0,0,0,0,0,0,0,0,0,0,16,1
1,16,0,0,0,0,0,0,0,0,0,0,0,0,16,1
1,16,3,3,3,3,3,3,3,3,3,3,3,3,16,1
1,16,3,3,3,3,8,3,3,8,3,3,3,3,16,1
1,16,0,0,0,0,0,0,0,0,0,0,0,0,16,1
1,16,0,0,0,0,0,0,0,0,0,0,0,0,16,1
1,16,16,16,16,16,16,16,16,16,16,16,16,16,16,1
1,1,1,1,1,1,1,1,1,1,1,1,1,1,1,1