0,1,1,0,0,1,1,0,0,1,1,0,0,1,1,0
1,0,0,1,1,0,0,1,1,0,0,1,1,0,0,1
0,1,7,0,0,2,2,0,0,2,2,0,0,7,1,0
1,0,0,1,1,0,0,7,7,0,0,1,1,0,0,1
0,1,7,0,0,2,2,0,0,2,2,0,0,7,1,0
1,0,0,1,1,0,0,3,3,0,0,1,1,0,0,1
0,1,7,0,0,2,2,0,0,2,2,0,0,7,1,0
1,0,0,1,1,0,0,1,1,0,0,1,1,0,0,1
0,1,1,0,0,1,1,0,0,1,1,0,0,1,1,0
1,0,0,1,1,0,0,1,1,0,0,1,1,0,0,1