0,1,0,1,0,1,1,1,1,1,1,0,1,0,1,0
1,0,1,0,1,1,8,4,4,8,1,1,0,1,0,1
0,1,0,1,0,1,16,16,16,16,1,0,1,0,1,0
1,0,1,0,1,0,1,0,0,1,0,1,0,1,0,1
0,1,0,1,0,1,1,1,1,1,1,0,1,0,1,0
1,0,8,0,1,0,1,0,0,1,0,1,0,8,0,1
0,1,0,1,0,1,0,1,1,0,1,0,1,0,1,0
1,0,1,0,1,0,1,0,0,1,0,1,0,1,0,1
0,0,0,0,0,0,0,0,0,0,0,0,0,0,0,0
0,0,0,0,0,0,0,0,0,0,0,0,0,0,0,0