0,0,0,0,0,0,0,0,0,0,0,0,0,0,0,0
0,0,0,0,0,0,3,4,4,0,3,0,0,0,0,0
0,0,0,0,0,0,3,13,13,3,0,0,0,0,0,0
0,0,0,0,0,0,0,8,8,0,0,0,0,0,0,0
0,0,0,0,0,0,13,14,14,13,0,0,0,0,0,0
0,0,0,0,0,0,0,0,0,0,0,0,0,0,0,0
3,13,3,0,0,0,0,0,0,0,0,0,0,3,13,3
0,0,0,0,0,3,0,0,0,0,3,0,0,0,0,0
0,2,2,2,3,3,0,0,0,0,3,3,2,2,2,0
0,0,0,0,0,0,0,0,0,0,0,0,0,0,0,0