0,0,0,0,5,8,1,1,1,1,8,5,0,0,0,0
0,0,0,8,1,1,5,0,0,5,1,1,8,0,0,0
0,0,0,0,0,0,0,0,0,0,0,0,0,0,0,0
0,0,0,1,1,1,0,0,0,0,1,1,1,0,0,0
0,0,1,1,1,1,1,0,0,1,1,1,1,1,0,0
0,0,1,16,16,16,1,0,0,1,16,16,16,1,0,0
0,0,0,16,8,16,0,0,0,0,16,8,16,0,0,0
0,0,1,16,16,16,1,0,0,1,16,16,16,1,0,0
0,0,1,1,1,1,1,0,0,1,1,1,1,1,0,0
0,0,0,1,1,1,0,0,0,0,1,1,1,0,0,0