0,0,0,0,0,0,0,0,0,0,0,0,0,0,0,0
0,0,1,1,1,1,0,1,1,1,0,1,1,1,1,0
0,0,1,8,5,1,0,1,8,1,0,1,5,8,1,0
0,0,1,5,5,1,0,1,8,1,0,1,5,5,1,0
0,0,1,1,1,1,0,1,1,1,0,1,1,1,1,0
0,0,0,0,0,0,0,0,0,0,0,0,0,0,0,0
0,0,1,1,1,1,1,1,1,1,1,1,1,1,1,0
0,0,16,16,16,16,16,16,16,16,16,16,16,16,16,0
0,0,1,1,1,1,1,1,1,1,1,1,1,1,1,0
0,0,0,0,0,0,0,0,0,0,0,0,0,0,0,0