1,1,1,1,4,1,1,1,1,1,1,4,1,1,1,1
1,2,2,4,2,4,1,1,1,1,4,2,4,2,2,1
1,2,0,0,0,0,7,7,7,7,0,0,0,0,2,1
1,2,0,0,0,7,4,4,4,4,7,0,0,0,2,1
1,2,3,3,3,0,0,0,0,0,0,3,3,3,2,1
1,1,1,1,1,0,0,0,0,0,0,1,1,1,1,1
4,4,4,2,1,0,0,0,0,0,0,1,2,4,4,4
4,4,2,1,0,0,0,0,0,0,0,0,1,2,4,4
4,2,1,0,0,0,0,0,0,0,0,0,0,1,2,4
2,1,0,0,0,0,0,0,0,0,0,0,0,0,1,2