0,0,0,0,0,0,4,4,4,4,0,0,0,0,0,0
0,0,0,0,0,4,4,4,4,4,4,0,0,0,0,0
0,0,0,0,4,4,4,4,4,4,4,4,0,0,0,0
0,0,0,4,4,4,2,2,2,2,4,4,4,0,0,0
0,0,4,4,4,4,2,5,5,2,4,4,4,4,0,0
4,4,4,4,4,4,2,2,2,2,4,4,4,4,4,4
4,5,4,0,0,0,0,0,0,0,0,0,0,4,5,4
4,4,4,0,0,0,0,0,0,0,0,0,0,4,4,4
4,4,4,4,4,4,4,4,4,4,4,4,4,4,4,4
4,4,4,4,4,4,4,4,4,4,4,4,4,4,4,4