0,0,0,0,0,6,6,0,0,0,0,6,6,0,0,0
6,6,0,0,6,8,8,6,0,0,6,8,8,6,0,0
8,8,6,0,0,6,6,0,0,0,0,6,6,0,0,6
6,6,0,0,0,0,0,0,6,6,0,0,0,0,6,8
0,0,0,6,6,0,0,6,8,8,6,0,0,0,0,6
0,0,6,8,8,6,0,0,6,6,0,0,0,0,0,0
0,0,0,6,6,0,0,0,0,0,0,6,6,0,0,0
6,6,0,0,0,0,6,6,0,0,6,8,8,6,0,0
8,6,6,0,0,6,8,8,6,0,0,6,6,0,0,6
6,6,0,0,0,0,6,6,0,0,0,0,0,0,0,6