0,5,5,5,5,5,5,5,5,5,5,5,5,5,5,0
0,0,5,5,5,5,5,3,3,5,5,5,5,5,0,0
6,0,0,5,5,5,3,7,7,3,5,5,5,0,0,6
5,5,0,0,5,5,3,7,7,3,5,5,0,0,5,5
6,6,6,0,0,5,5,3,3,5,5,0,0,6,6,6
5,5,5,5,0,0,5,5,5,5,0,0,5,5,5,5
6,6,6,6,6,0,0,5,5,0,0,6,6,6,6,6
5,5,5,5,5,5,0,0,0,0,5,5,5,5,5,5
6,6,6,6,6,6,6,0,0,6,6,6,6,6,6,6
5,5,5,5,5,5,0,0,0,0,5,5,5,5,5,5