0,0,0,0,0,0,0,3,3,0,0,0,0,0,0,0
0,0,0,0,6,0,3,8,8,3,0,6,0,0,0,0
0,0,0,0,6,0,3,8,8,3,0,6,0,0,0,0
0,0,0,0,6,7,7,3,3,7,7,6,0,0,0,0
0,0,0,8,6,3,7,7,7,7,3,6,8,0,0,0
0,0,0,0,6,7,7,7,7,7,7,6,0,0,0,0
0,0,0,0,6,7,7,7,7,7,7,6,0,0,0,0
0,0,0,0,0,6,7,7,7,7,6,0,0,0,0,0
0,0,0,0,0,0,6,7,7,6,0,0,0,0,0,0
0,0,0,0,0,0,0,6,6,0,0,0,0,0,0,0