0,0,0,0,0,3,14,5,5,14,3,0,0,0,0,0
0,0,0,0,0,0,3,14,14,3,0,0,0,0,0,0
0,0,0,13,4,13,0,3,3,0,13,4,13,0,0,0
0,0,0,0,0,0,0,0,0,0,0,0,0,0,0,0
0,0,8,3,3,3,3,8,8,3,3,3,3,8,0,0
0,0,0,0,0,0,0,0,0,0,0,0,0,0,0,0
0,3,3,0,3,3,0,3,3,0,3,3,0,3,3,0
0,0,0,0,0,0,0,0,0,0,0,0,0,0,0,0
3,2,2,3,0,0,3,2,2,3,0,0,3,2,2,3
0,0,0,0,0,0,0,0,0,0,0,0,0,0,0,0